1111111111111111111
1000001000000000001
1111101011111110101
1000000000000010101
1010111110101110101
1010001000101000101
1011101010101011101
1000001010101010001
1011111010111010111
1000000010001010001
1111111011101011101
1000000000101000001
1011111110101111101
1000000010000000001
1111111111111111111
