111111111111111
101000100000101
101110101110101
100010000010001
111011111111111
101000001000001
101111101011111
100000100010001
101010111110111
101010100010101
111010101010101
100010101000101
101111101111101
100000000000001
111111111111111
