111111111110111
101000101110111
101000100000101
111000101010101
100010001000101
101110101111101
001110100011111
111111111111111
