111111111111111101
100000100000010001
111010101111010101
101000001000000101
101010111011110101
100010000010000101
100010000010010101
111000111110100101
100010000110100001
101111111000111101
100000100010100011
111111101110101011
000000001000001001
111111111111111111